Gg, Re, Gg, Re, Gg, Re, Gg, Re, Gg, Re, Gg, Re, Gg, Re, Gg, Re, Gg, Re, Gg, Re, Gg
Re, Gg, Re, Gg, Re, Gg, Re, Gg, Re, Gg, Re, Gg, Re, Gg, Re, Gg, Re, Gg, Re, Gg, Re
Gg, Re, Gg, Re, Gg, Re, Gg, Re, Gg, Re, Gg, Re, Gg, Re, Gg, Re, Gg, Re, Gg, Re, Gg
